mundo	ˈmun̩do
tierra	ˈtjerra
suelo	ˈswelo
polvo	ˈpolβo
lodo	ˈloðo
arena	aˈrena
mundo	ˈmun̩do
tierra	ˈtjerra
suelo	ˈswelo
polvo	ˈpolβo
lodo	ˈloðo
arena	aˈrena
montaɲa	
loma	ˈloma
cerro	ˈθerro
acantilado	akan̩tiˈlaðo
barranca	
pampa	ˈpampa
llanura	ʎaˈnura
campo	ˈkampo
valle	ˈbaʎe
isla	ˈisla
continente	kon̩tiˈnen̩te
mundo	ˈmun̩do
tierra	ˈtjerra
suelo	ˈswelo
polvo	ˈpolβo
lodo	ˈloðo
arena	aˈrena
montaɲa	
loma	ˈloma
cerro	ˈθerro
acantilado	akan̩tiˈlaðo
barranca	
pampa	ˈpampa
llanura	ʎaˈnura
campo	ˈkampo
valle	ˈbaʎe
isla	ˈisla
continente	kon̩tiˈnen̩te
tierra firme	
ribera	rriˈβera
playa	ˈplaɟa
costa	ˈkosta
cueva	ˈkweβa
gruta	ˈgruta
agua	ˈaɣwa
mar	mar
calma	ˈkalma
agitado	axiˈtaðo, -a
borrascoso	borrasˈkoso, -a
espuma	esˈpuma
océano	
lago	ˈlaɣo
golfo	ˈgolfo
bahía	
laguna	laˈɣuna
arrecife	arreˈθife
promontorio	promon̩ˈtorjo
punta	ˈpun̩ta
ola	ˈola
marea	maˈrea
bajamar	baxaˈmar
pleamar	pleaˈmar
río	
corriente	koˈrrjen̩te
arroyo	aˈrroɟo
remolino	rremoˈlino
manantial	manan̩ˈtjal
pozo	ˈpoθo
pantano	pan̩ˈtano
cascada	kasˈkaða
salto	ˈsal̩to
bosque	ˈboske
selva	ˈselβa
árbol	
madera	maˈðera
piedra	ˈpjeðra
roca	ˈrroka
terremoto	terreˈmoto
temblor	temˈblor
cielo	ˈθjelo
sol	sol
luna	ˈluna
estrella	esˈtreʎa
relámpago	
trueno	ˈtrweno
rayo	ˈrraɟo
tempestad	
tormenta	torˈmen̩ta
arco iris	
luz	luθ
oscuridad	o<span class="super">β</span>skuriˈðað
tinieblas	
sombra	ˈsombra
rocío	
aire	ˈai̯re
viento	ˈbjen̩to
nube	ˈnuβe
neblina	neˈβlina
niebla	ˈnjeβla
lluvia	ˈʎuβja
nieve	ˈnjeβe
hielo	ˈɟelo
tiempo	ˈtjempo
fuego	ˈfweɣo
llama	ˈʎama
humo	ˈumo
cenizas	
brasas	ˈbrasas
quemar	keˈmar
quemarse	
arder	arˈðer
encender	eṇθen̩ˈder
apagar	apaˈɣar
extinguir	estiŋˈgir
fósforo	
cerilla	θeˈriʎa
leɲa	
carbón	
persona	perˈsona
hombre	ˈombre
mujer	muˈxer
varón	
macho	ˈmaʧo
hembra	ˈembra
muchacho	muˈʧaʧo, -a
el joven	
muchacha	muˈʧaʧa
la joven	
niɲo	
niɲo	
bebé	
nene	ˈnene, -a
marido	maˈriðo
esposo	esˈposo, -a
esposa	esˈposa
casarse	
casamiento	kasaˈmjen̩to
boda	ˈboða
divorcio	diˈβorθjo
padre	ˈpaðre
madre	ˈmaðre
padres	
hombre casado	
mujer casada	
hijo	ˈixo, -a
hija	
hijo	ˈixo, -a
hija	
hermano	erˈmano, -a
hermano mayor	
hermano menor	
hermana	ermaˈnar
hermana mayor	
hermana menor	
hermano	erˈmano, -a
hermana	ermaˈnar
gemelos	
mellizo	meˈʎiθo, -a
abuelo	aˈβwelo
anciano	aṇˈθjano, -a
hombre viejo	
abuela	
anciana	
mujer vieja	
nieto	ˈnjeto, -a
nieta	
tío	
hermano de la madre	
hermano del padre	
tía	
hermana de la madre	
hermana del padre	
sobrino	soˈβrino, -a
sobrina	
primo	ˈprimo, -a
prima	ˈprima
antepasados	
descendientes	
suegro	ˈsweɣro, -a
suegro	ˈsweɣro, -a
suegra	
suegra	
yerno	ˈɟerno
yerno	ˈɟerno
nuera	ˈnwera
nuera	ˈnwera
padrastro	paˈðrastro
madrastra	maˈðrastra
hijastro	iˈxastro, -a
entenado	en̩teˈnaðo, -a
hijastra	
entenada	
huérfano	
huérfana	
viuda	
viudo	ˈbjuðo, -a
parientes	
parentela	paren̩ˈtela
familia	faˈmilja
yo	ɟo
tú	
usted	
él	
ella	ˈeʎa
ello	ˈeʎo
nosotros	noˈsotros, -as
nosotras	
nosotros	noˈsotros, -as
nosotras	
nosotros	noˈsotros, -as
nosotras	
ustedes	
ellos	ˈeʎos
ellas	ˈeʎas
animal	aniˈmal
masculino	maskuˈlino
macho	ˈmaʧo
femenino	femeˈnino
hembra	ˈembra
ganado	gaˈnaðo, -a
pradera	praˈðera
potrero	poˈtrero
pastor	pasˈtor
vaquero	baˈkero, -a
establo	esˈtaβlo
ganado	gaˈnaðo, -a
toro	ˈtoro
buey	bwei̯
vaca	ˈbaka
becerro	beˈθerro
ternero	terˈnero, -a
oveja	oˈβexa
carnero	karˈnero
morueco	moˈrweko
oveja	oˈβexa
borrego	boˈrreɣo, -a
cordero	korˈðero
jabalí	
puerca	
cochina	koˈʧina
cerda	ˈθerða
cerdo	ˈθerðo, -a
puerco	ˈpwerko, -a
chancho	ˈʧanʧo
cabra	ˈkaβra
chivo	ˈʧiβo, -a
macho cabrío	
cabrito	kaˈβrito, -a
caballo	kaˈβaʎo
caballo padre	
semental	semen̩ˈtal
yegua	ˈɟeɣwa
potro	ˈpotro
potrillo	poˈtriʎo
asno	ˈasno
burro	ˈburro
mulo	ˈmulo, -a
mula	ˈmula
ave	ˈaβe
gallo	ˈgaʎo
gallina	gaˈʎina
pollo	ˈpoʎo
ganso	ˈganso, -a
pato	ˈpato
ánade	
nido	ˈniðo
pájaro	
ave	ˈaβe
gaviota	gaˈβjota
garza	ˈgarθa
águila	
gavilán	
halcón	
buitre	ˈbwitre
murciélago	
loro	ˈloro
papagayo	papaˈɣaɟo
cuervo	ˈkwerβo
paloma	paˈloma
lechuza	leˈʧuθa
buho	
perro	ˈperro
conejo	koˈnexo
gato	ˈgato
zarigüeya	
ratón	
rata	ˈrrata
pez	peθ
pescado	pesˈkaðo
aleta	aˈleta
escama	esˈkama
agalla	aˈɣaʎa
valva	ˈbalβa
tiburón	
delfín	
ballena	baˈʎena
raya	ˈrraɟa
pastinaca	pastiˈnaka
anguila de agua dulce	
lobo	ˈloβo
león	
oso	ˈoso
zorro	ˈθorro
venado	beˈnaðo
ciervo	ˈθjerβo, -a
a	a
mono	ˈmono
elefante	eleˈfan̩te, -a
camello	kaˈmeʎo, -a
insecto	inˈsekto
piojo	ˈpjoxo
liendre	ˈljen̩dre
pulga	ˈpulɣa
ciempiés	
alacrán	
escorpión	
cucaracha	kukaˈraʧa
hormiga	orˈmiɣa
araɲa	
telaraɲa	
abeja	aβeˈxa
cera de abeja	
colmena	kolˈmena
avispa	aˈβispa
mosca	ˈmoska
jején	
mosquito	mosˈkito
lombriz	lomˈbriθ
gusano	guˈsano
culebra	kuˈleβra
serpiente	serˈpjen̩te
luciérnaga	
mariposa	mariˈposa
saltamontes	sal̩taˈmon̩tes
caracol	karaˈkol
rana	ˈrrana
lagartija	laɣarˈtixa
cocodrilo	kokoˈðrilo
caimán	
tortuga	torˈtuɣa
cuerpo	ˈkwerpo
piel	pjel
cutis	ˈkutis
pellejo	peˈʎexo
carne	ˈkarne
cabello	kaˈβeʎo
pelo	ˈpelo
barba	ˈbarβa
vello	ˈbeʎo
pelo púbico	
caspa	ˈkaspa
sangre	ˈsaŋgre
vena	ˈbena
arteria	arˈterja
hueso	ˈweso
costilla	kosˈtiʎa
cuerno	ˈkwerno
cola	ˈkola
espalda	esˈpal̩da
espinazo	espiˈnaθo
espina dorsal	
cabeza	kaˈβeθa
sien	sjen
cráneo	
calavera	kalaˈβera
cerebro	θeˈreβro
sesos	
cara	ˈkara
frente	ˈfren̩te
mandíbula	
mejilla	meˈxiʎa
mentón	
barbilla	barˈβiʎa
ojo	ˈoxo
ceja	ˈθexa
párpado	
pestaɲa	
parpadear	parpaðeˈar
pestaɲear	
oreja	oˈrexa
lóbulo	
cerumen	θeˈrumen
nariz	naˈriθ
ventana de la nariz	
moco	ˈmoko
boca	ˈboka
pico	ˈpiko
labio	ˈlaβjo
lengua	ˈleŋgwa
diente	ˈdjen̩te
encías	
molar	moˈlar
muela	ˈmwela
cuello	ˈkweʎo
nuca	ˈnuka
garganta	garˈɣan̩ta
hombro	ˈombro
escápula	
omóplato	
clavícula	
brazo	ˈbraθo
sobaco	soˈβako
axila	aˠˈsila
codo	ˈkoðo
muɲeca	
mano	ˈmano
palma de la mano	
dedo	ˈdeðo
pulgar	pulˈɣar
uɲa	
garra	ˈgarra
pierna	ˈpjerna
pata	ˈpata
muslo	ˈmuslo
pantorrilla	pan̩toˈrriʎa
rodilla	rroˈðiʎa
pie	pje
tobillo	toˈβiʎo
talón	
huella	ˈweʎa
dedo del pie	
ala	ˈala
pluma	ˈpluma
pecho	ˈpeʧo
seno	ˈseno
pezón	
teta	ˈteta
ubre	uˈβre
ombligo	omˈbliɣo
corazón	
pulmón	
hígado	
riɲón	
bazo	ˈbaθo
estómago	
barriga	baˈrriɣa
intestinos	
tripas	
cintura	θin̩ˈtura
cadera	kaˈðera
nalgas	
trasero	traˈsero
matriz	maˈtriθ
vientre	ˈbjen̩tre
testículo	
pene	ˈpene
respirar	rrespiˈrar
aliento	aˈljen̩to
bostezar	bosteˈθar
tener hipo	
toser	toˈser
estornudar	estornuˈðar
sudar	suˈðar
escupir	eskuˈpir
saliva	saˈliβa
a	a
vomitar	bomiˈtar
morder	morˈðer
lamer	laˈmer
gotear	goteˈar
babear	baβeˈar
dormir	dorˈmir
roncar	rroŋˈkar
soɲar	
despertarse	
ventosear	ben̩toseˈar
flato	ˈflato
orinar	oriˈnar
mear	meˈar
defecar	defeˈkar
excremento	eskreˈmen̩to
tener relaciones sexuales	
temblar	temˈblar
baɲar	
engendrar	eŋxen̩ˈdrar
procrear	prokreˈar
nacer	naˈθer
embarazada	embaraˈθaða
preɲada	
concebir	koṇθeˈβir
vivir	biˈβir
vivo	ˈbiβo
vida	ˈbiða
morir	moˈrir
muerto	ˈmwerto, -a
ahogado	aoˈɣaðo, -a
matar	maˈtar
cadáver	
enterrar	en̩teˈrrar
sepultar	sepul̩ˈtar
sepulcro	seˈpulkro
tumba	ˈtumba
fuerte	ˈfwerte
poderoso	poðeˈroso, -a
débil	
sano	ˈsano, -a
salud	
enfermo	eɱˈfermo, -a
enfermedad	
fiebre	ˈfjeβre
bocio	ˈboθjo
coto	ˈkoto
catarro	kaˈtarro
resfriado	rresfriˈaðo
herida	eˈriða
llaga	ˈʎaɣa
cardenal	karðeˈnal
magulladura	maɣuʎaˈmjen̩to
contusión	
hinchazón	
comezón	
ampolla	amˈpoʎa
furúnculo	
forúnculo	
pus	pus
cicatriz	θikaˈtriθ
sanar	saˈnar
curar	kuˈrar
doctor	dokˈtor(a)
médico	
medicina	meðiˈθina
remedio	rreˈmeðjo
veneno	beˈneno
cansado	kanˈsaðo, -a
descansar	deskanˈsar
perezoso	pereˈθoso
flojo	ˈfloxo, -a
calvo	ˈkalβo, -a
pelado	peˈlaðo
lisiado	liˈsjaðo, -a
sordo	ˈsorðo, -a
mudo	ˈmuðo, -a
ciego	ˈθjeɣo, -a
ebrio	ˈeβrjo, -a
embriagado	embrjaˈɣaðo, -a
desnudo	desˈnuðo
comer	koˈmer
comida	koˈmiða
alimento	aliˈmen̩to
cocido	koˈθiðo
cocinado	
crudo	ˈkruðo
maduro	maˈðuro, -a
inmaduro	i<span class="super">n</span>maˈðuro, -a/i<span class="super">m</span>maˈðuro, -a
no maduro	
verde	ˈberðe
podrido	poˈðriðo, -a
beber	beˈβer
hambre	ˈambre
hambre	ˈambre
sed	
chupar	ʧuˈpar
masticar	mastiˈkar
mascar	masˈkar
tragar	traˈɣar
sofocar	sofoˈkar
cocinar	koθiˈnar
hervir	erˈβir
asar	aˈsar
freír	
hornear	orneˈar
horno	ˈorno
olla	ˈoʎa
caldera	kal̩ˈdera
cacerola	kaθeˈrola
cazuela	kaˈθwela
plato	ˈplato
fuente	ˈfwen̩te
plato	ˈplato
tazón	
cántaro	
jarro	ˈxarro
taza	ˈtaθa
copa	ˈkopa
platillo	plaˈtiʎo
cuchara	kuˈʧara
cuchillo	kuˈʧiʎo
tenedor	teneˈðor
tenazas	teˈnaθa
comida	koˈmiða
desayuno	desaˈɟuno
almuerzo	alˈmwerθo
comida	koˈmiða
cena	ˈθena
pelar	peˈlar
cribar	kriˈβar
colar	koˈlar
cerner	θerˈner
raspar	rrasˈpar
rallar	rraˈʎar
mezclar	meθˈklar
mixturar	
pan	pan
masa	ˈmasa
amasar	amaˈsar
harina	aˈrina
aplastar	aplasˈtar
moler	moˈler
molino	moˈlino
mortero	morˈtero
mano de mortero	
salchicha	salˈʧiʧa
sopa	ˈsopa
legumbres	
frijol	ˈfrixol
poroto	poˈroto
papa	ˈpapa
fruta	ˈfruta
racimo	rraˈθimo
higo	ˈiɣo
uva	ˈuβa
nuez	nweθ
aceituna	aθei̯ˈtuna
oliva	oˈliβa
aceite	aˈθei̯te
grasa	ˈgrasa
sal	sal
pimienta	piˈmjen̩ta
ají	
miel	mjel
azúcar	
leche	ˈleʧe
ordeɲar	
queso	ˈkeso
mantequilla	man̩teˈkiʎa
manteca	man̩ˈteka
bebida	beˈβiða
a	a
aguamiel	aɣwaˈmjel
vino	ˈbino
cerveza	θerˈβeθa
bebida fermentada	
huevo	ˈweβo
yema	ˈɟema
vestirse	
ropa	ˈrropa
sastre	ˈsastre, -a
tela	ˈtela
lana	ˈlana
lino	ˈlino
algodón	
seda	ˈseða
fieltro	ˈfjel̩tro
cuero	ˈkwero
hilar	iˈlar
huso	ˈuso
tejer	teˈxer
telar	teˈlar
coser	koˈser
aguja	aˈɣuxa
punzón	
hilo	ˈilo
teɲir	
capa	ˈkapa
manta	ˈman̩ta
poncho	ˈponʧo
ruana	ˈrrwana
vestido	besˈtiðo
abrigo	aˈβriɣo
saco	ˈsako
camisa	kaˈmisa
falda	ˈfal̩da
falda de hierbas	
pantalones	
calzones	kaḷˈθones
media	ˈmeðja
calcetín	
zapato	θaˈpato
bota	ˈbota
zapatero	θapaˈtero
sombrero	somˈbrero
gorro	ˈgorro
cinturón	
faja	ˈfaxa
guante	ˈgwan̩te
velo	ˈbelo
bolsillo	
botón	
alfiler	alfiˈler
adorno	aˈðorno
ornato	orˈnato
joya	ˈxoɟa
anillo	aˈniʎo
sortija	sorˈtixa
brazalete	braθaˈlete
pulsera	pulˈsera
collar	koˈʎar
chaquira	
abalorio	aβaˈlorjo
arete	aˈrete
aro	ˈaro
pendiente	pen̩ˈdjen̩te
cinta	ˈθin̩ta
tocado	toˈkaðo
tatuaje	tatuˈaxe
paɲuelo	
trapo	ˈtrapo
toalla	toˈaʎa
peine	ˈpei̯ne
cepillo	θeˈpiʎo
trenzar	treṇˈθar
navaja de afeitar	
ungüento	
jabón	
espejo	esˈpexo
habitar	aβiˈtar
morar	moˈrar
casa	ˈkasa
cabaɲa	
choza	ˈʧoθa
casa de huerta	
granja	ˈgraŋxa
toldo	ˈtol̩do
cancha	ˈkanʧa
patio	ˈpatjo
casa de hombres	
cocina	koˈθina
casa de reunión	
cuarto	ˈkwarto
pieza	ˈpjeθa
puerta	ˈpwerta
jamba de puerta	
larguero	larˈɣero
cerradura	θerraˈðura
candado	kan̩ˈdaðo
cerrojo	θeˈrroxo
llave	ˈʎaβe
ventana	ben̩ˈtana
pared	paˈreð
muro	ˈmuro
fogón	
estufa	esˈtufa
chimenea	ʧimeˈnea
escalera	eskaˈlera
cama	ˈkama
almohada	almoˈaða
frazada	fraˈθaða
cobija	koˈβixa
silla	ˈsiʎa
mesa	ˈmesa
lámpara	
antorcha	an̩ˈtorʧa
vela	ˈbela
repisa	rreˈpisa
batea	baˈtea
artesa	arˈtesa
techo	ˈteʧo
paja	ˈpaxa
cumbrera	kumˈbrera
viga	ˈbiɣa
viga	ˈbiɣa
poste	ˈposte
tabla	ˈtaβla
arco	ˈarko
albaɲil	
masón	
ladrillo	laˈðriʎo
argamasa	arɣaˈmasa
adobe	aˈðoβe
labrador	laβraˈðor(a)
ranchero	rranˈʧero, -a
agricultor	aɣrikul̩ˈtor(a)
chacra	ˈʧakra
jardín	
huerto	ˈwerto
cultivar	kul̩tiˈβar
labrar	laˈβrar
cerca	ˈθerka
cerco	ˈθerko
zanja	ˈθaŋxa
canal	kaˈnal
arar	aˈrar
surco	ˈsurko
excavar	eskaˈβar
cavar	kaˈβar
laya	ˈlaɟa
pala	ˈpala
azadón	
azada	aˈθaða
horqueta	orˈketa
rastro	ˈrrastro
rastrillo	rrasˈtriʎo
sembrar	semˈbrar
desparramar	desparraˈmar
semilla	seˈmiʎa
segar	seˈɣar
cosechar	koseˈʧar
hoz	oθ
guadaɲa	
trillar	triˈʎar
desgranar	desɣraˈnar
era	ˈera
lugar para trillar	
cosecha	koˈseʧa
siega	ˈsjeɣa
grano	ˈgrano
trigo	ˈtriɣo
cebada	θeˈβaða
centeno	θen̩ˈteno
avena	aˈβena
maíz	
arroz	aˈrroθ
hierba	ˈɟerβa
pasto	ˈpasto
heno	ˈeno
paja	ˈpaxa
planta	ˈplan̩ta
plantar	plan̩ˈtar
sembrar	semˈbrar
raíz	
rama	ˈrrama
hoja	ˈoxa
flor	flor
roble	ˈrroβle
haya	ˈaɟa
abedul	aβeˈðul
pino	ˈpino
abeto	aˈβeto
bellota	beˈʎota
enredadera	enrreðaˈðera
bejuco	beˈxuko
liana	liˈana
tabaco	taˈβako
fumar	fuˈmar
pipa	ˈpipa
tocón	
cepa	ˈθepa
tronco	ˈtroŋko
rama bifurcada	
corteza	korˈteθa
savia	ˈsaβja
palmera	palˈmera
coco	ˈkoko
cítrico	
plátano	
banano	baˈnano
baniano	
camote	kaˈmote
batata	baˈtata
ɲame	
mandioca	man̩ˈdjoka
yuca	ˈɟuka
calabaza	kalaˈβaθa
zapallo	θaˈpaʎo
calabaza	kalaˈβaθa
calabazo	kalaˈβaθo
bambú	
caɲa de azúcar	
barbasco	
ortiga	orˈtiɣa
hongo	ˈoŋgo
seta	ˈseta
hacer	aˈθer
trabajar	traβaˈxar
encorvar	eŋkorˈβar
doblar	doˈβlar
doblar	doˈβlar
amarrar	amaˈrrar
atar	aˈtar
desatar	desaˈtar
cadena	kaˈðena
cuerda	ˈkwerða
soga	ˈsoɣa
nudo	ˈnuðo
golpear	golpeˈar
machacar con el puɲo	
cortar	korˈtar
tumbar	tumˈbar
talar	taˈlar
tajar	taˈxar
picar	piˈkar
apuɲalar	
tijeras	
hacha	ˈaʧa
azuela	aˈθwela
quebrar	keˈβrar
quebrado	keˈβraðo
hender	en̩ˈder
partir	parˈtir
romper	rromˈper
rasgar	rrasˈɣar
desollar	desoˈʎar
frotar	froˈtar
enjugar	eŋxuˈɣar
alargar	alarˈɣar
estirar	estiˈrar
tender	ten̩ˈder
tirar	tiˈrar
jalar	xaˈlar
extender	esten̩ˈder
esparcir	esparˈθir
colgar	kolˈɣar
apretar	apreˈtar
oprimir	opriˈmir
estrujar	estruˈxar
exprimir	espriˈmir
vaciar	baˈθiar
verter	berˈter
derramar	derraˈmar
lavar	laˈβar
barrer	baˈrrer
escoba	esˈkoβa
herramienta	erraˈmjen̩ta
carpintero	karpin̩ˈtero, -a
edificar	eðifiˈkar
construir	ko<span class="super">n</span>struˈir/ko<span class="super">n</span>sˈtrwir
perforar	perfoˈrar
ahuecar	aweˈkar
serrucho	seˈrruʧo
sierra	ˈsjerra
martillo	marˈtiʎo
clavo	ˈklaβo
adhesivo	aðeˈsiβo
herrero	eˈrrero
fragua	ˈfraɣwa
yunque	ˈɟuŋke
fundir	fun̩ˈdir
oro	ˈoro
plata	ˈplata
cobre	ˈkoβre
bronce	ˈbroṇθe
hierro	ˈɟerro
plomo	ˈplomo
estaɲo	
alfarero	alfaˈrero, -a
moldear	mol̩deˈar
formar	forˈmar
barro	ˈbarro
arcilla	arˈθiʎa
vidrio	ˈbiðrjo
tejer	teˈxer
trenzar	treṇˈθar
cesto	ˈθesto
canasto	kaˈnasto
canasta	kaˈnasta
estera	esˈtera
tapete	taˈpete
alfombra	alˈfombra
bolsa de malla	
abanico	aβaˈniko
abanicar	aβaniˈkar
aventar	aβen̩ˈtar
ventilar	ben̩tiˈlar
esculpir	eskulˈpir
escultor	eskul̩ˈtor(a)
estatua	esˈtatwa
escoplo	esˈkoplo
cincel	θiṇˈθel
pintura	pin̩ˈtura
pintar	pin̩ˈtar
mover	moˈβer
volcar	bolˈkar
dar vuelta	
dar vuelta	
voltear	bol̩teˈar
enrollar	enrroˈʎar
envolver	embolˈβer
rodar	rroˈðar
arrollar	arroˈʎar
enrollar	enrroˈʎar
dejar caer	
torcer	torˈθer
ascender	asθen̩ˈder
subir	suˈβir
levantar	leβan̩ˈtar
caer	kaˈer
escurrir	eskuˈrrir
echar	eˈʧar
tirar	tiˈrar
coger	koˈxer
sacudir	sakuˈðir
fluir	fluˈir
correr	koˈrrer
hundir	un̩ˈdir
flotar	floˈtar
nadar	naˈðar
zambullirse	
salpicar	salpiˈkar
navegar	naβeˈɣar
volar	boˈlar
soplar	soˈplar
gatear	gateˈar
arrodillarse	arroðiˈʎarse
agacharse	
ponerse en cuclillas	
resbalar	rresβaˈlar
saltar	sal̩ˈtar
brincar	briŋˈkar
patear	pateˈar
bailar	bai̯ˈlar
caminar	kamiˈnar
andar	an̩ˈdar
lisiar	liˈsjar
correr	koˈrrer
ir	ir
subir	suˈβir
trepar	treˈpar
bajar	baˈxar
descender	desθen̩ˈder
salir	saˈlir
venir	beˈnir
volver	bolˈβer
regresar	rreɣreˈsar
irse	
marcharse	
partir	parˈtir
desaparecer	desapareˈθer
huir	uˈir
seguir	seˈɣir
perseguir	perseˈɣir
llegar	ʎeˈɣar
alcanzar	alkaṇˈθar
acercarse	
aproximarse	
entrar	en̩ˈtrar
llevar	ʎeˈβar
cargar	karˈɣar
llevar en la mano	
llevar a la espalda	
en el hombro	
llevar sobre la cabeza	
llevar bajo el brazo	
traer	traˈer
enviar	embiˈar
mandar	man̩ˈdar
guiar	giˈar
conducir	kon̩duˈθir
conducir	kon̩duˈθir
montar	mon̩ˈtar
a	a
empujar	empuˈxar
carretera	karreˈtera
camino	kaˈmino
senda	ˈsen̩da
puente	ˈpwen̩te
carro	ˈkarro
carretón	
rueda	ˈrrweða
eje	ˈexe
yugo	ˈɟuɣo
buque	ˈbuke
barco	ˈbarko
bote	ˈbote
canoa	kaˈnoa
batanga	
balsa	ˈbalsa
remo	ˈrremo
remo corto	
remar	rreˈmar
timón	
mástil	
ancla	ˈaŋkla
puerto	ˈpwerto
desembarcar	desemβarˈkar
tener	teˈner
poseer	poˈser/poseˈer
tener	teˈner
tomar	toˈmar
agarrar	aɣaˈrrar
empuɲar	
asir	aˈsir
tener	teˈner
apoyar	apoˈɟar
obtener	oβteˈner
conseguir	konseˈɣir
conservar	konserˈβar
retener	rreteˈner
guardar	gwarˈðar
cosa	ˈkosa
dar	dar
devolver	deβolˈβer
conservar	konserˈβar
proteger	proteˈxer
salvar	salˈβar
rescatar	rreskaˈtar
destruir	destruˈir
daɲar	
herir	eˈrir
buscar	busˈkar
encontrar	eŋkon̩ˈtrar
hallar	aˈʎar
perder	perˈðer
soltar	sol̩ˈtar
largar	larˈɣar
dinero	diˈnero
moneda	moˈneða
rico	ˈrriko, -a
pobre	ˈpoβre
mendigo	men̩ˈdiɣo, -a
avaro	aˈβaro, -a
mezquino	meθˈkino, -a
prestar	presˈtar
pedir prestado	
deber	deˈβer
deuda	ˈdeu̯ða
pagar	paˈɣar
calcul	
cuenta	ˈkwen̩ta
impuesto	imˈpwesto
tributo	triˈβuto
alquilar	alkiˈlar
emplear	empleˈar
salario	saˈlarjo
sueldo	ˈswel̩do
ganar	gaˈnar
comprar	komˈprar
vender	ben̩ˈder
trocar	troˈkar
comerciante	komerˈθjan̩te, -a
mercado	merˈkaðo
tienda	ˈtjen̩da
almacén	
precio	ˈpreθjo
caro	ˈkaro
barato	baˈrato
repartir	rreparˈtir
distribuir	distriβuˈir
pesar	peˈsar
después	
atrás	
detrás	
al lado de	
abajo	aˈβaxo
bajo	ˈbaxo
debajo	deˈβaxo
delante	deˈlan̩te
antes de	
delantero	delan̩ˈtero
delante	deˈlan̩te
adentro	aˈðen̩tro
dentro	ˈden̩tro
afuera	aˈfwera
fuera	ˈfwera
exterior	esteˈrjor
debajo	deˈβaxo
arriba	aˈrriβa
encima	eṇˈθima
lugar	luˈɣar
sitio	ˈsitjo
poner	poˈner
sentar	sen̩ˈtar
acostarse	
echarse	
poner de pie	
quedar	keˈðar
permanecer	permaneˈθer
sobras	
recoger	rrekoˈxer
reunir	rreuˈnir
recoger	rrekoˈxer
amontonar	amon̩toˈnar
juntar	xun̩ˈtar
unir	uˈnir
separar	sepaˈrar
apartar	aparˈtar
dividir	diβiˈðir
abrir	aˈβrir
cerrar	θeˈrrar
cubrir	kuˈβrir
esconder	eskon̩ˈder
alto	ˈal̩to
elevado	eleˈβaðo, -a
bajo	ˈbaxo
cima	ˈθima
fondo	ˈfon̩do
final	fiˈnal
extremo	esˈtremo
puntiagudo	pun̩tjaˈɣuðo, -a
borde	ˈborðe
orilla	oˈriʎa
margen	ˈmarxen
lado	ˈlaðo
costado	kosˈtaðo
medio	ˈmeðjo
centro	ˈθen̩tro
derecha	deˈreʧa
izquierda	iθˈkjerða
próximo	
lejos	ˈlexos
este	ˈeste, ˈesta, ˈesto
levante	leˈβan̩te
oeste	oˈeste
poniente	poˈnjen̩te
norte	ˈnorte
sur	sur
crecer	kreˈθer
medir	meˈðir
braza	ˈbraθa
grande	ˈgran̩de
chico	ˈʧiko
pequeɲo	
largo	ˈlarɣo
alto	ˈal̩to
corto	ˈkorto
ancho	ˈanʧo
amplio	ˈampljo, -a
angosto	aŋˈgosto, -a
estrecho	esˈtreʧo
grueso	ˈgrweso
delgado	delˈɣaðo, -a
profundo	proˈfun̩do
hondo	ˈon̩do
bajo	ˈbaxo
poco profundo	
plano	ˈplano
derecho	deˈreʧo
recto	ˈrrekto
torcido	torˈθiðo
gancho	ˈganʧo
esquina	esˈkina
rincón	
cruz	kruθ
cuadrado	kwaˈðraðo
redondo	rreˈðon̩do
círculo	
pelota	peˈlota
esfera	esˈfera
globo	ˈgloβo
línea	
agujero	aɣuˈxero
semejante	semeˈxan̩te
parecido	pareˈθiðo
cambiar	kamˈbjar
mudar	muˈðar
cero	ˈθero
nada	ˈnaða
uno	ˈuno
dos	dos
tres	tres
cuatro	ˈkwatro
cinco	ˈθiŋko
seis	sei̯s
siete	ˈsjete
ocho	ˈoʧo
nueve	ˈnweβe
diez	djeθ
once	ˈoṇθe
doce	ˈdoθe
quince	ˈkiṇθe
veinte	ˈbei̯n̩te
ciento	ˈθjen̩to
cien	θjen
mil	mil
contar	kon̩ˈtar
cada	ˈkaða
todo	ˈtoðo
mucho	ˈmuʧo
más	
poco	ˈpoko
bastante	basˈtan̩te
suficiente	sufiˈθjen̩te
un poco	
algo	ˈalɣo
alguno	alˈɣuno, -a
multitud	
lleno	ˈʎeno
vacío	
pedazo	peˈðaθo
parte	ˈparte
mitad	
solo	ˈsolo
solamente	solaˈmen̩te
primero	priˈmero
último	
segundo	seˈɣun̩do
par	par
dos veces	
tercero	terˈθero
tres veces	
edad	
nuevo	ˈnweβo, -a
tierno	ˈtjerno, -a
joven	ˈxoβen
viejo	ˈbjexo, -a
a	a
temprano	temˈprano
tarde	ˈtarðe
ahora	aˈora
en seguida	
inmediatamente	i<span class="super">n</span>meðjataˈmen̩te/i<span class="super">m</span>meðjataˈmen̩te
rápido	
despacio	desˈpaθjo
lentamente	
apurarse	
darse prisa	
demorar	demoˈrar
retrasar	rretraˈsar
tardar	tarˈðar
empezar	empeˈθar
comenzar	komeṇˈθar
inicio	iˈniθjo
durar	duˈrar
fin	fin
acabar	akaˈβar
terminar	termiˈnar
finalizar	finaliˈθar
terminar	termiˈnar
detenerse	
cesar	θeˈsar
listo	ˈlisto, -a
preparado	prepaˈraðo
siempre	ˈsjempre
a menudo	
frecuentemente	
a veces	
pronto	ˈpron̩to
por mucho tiempo	
nunca	ˈnuŋka
jamás	
otra vez	
de nuevo	
día	
noche	ˈnoʧe
madrugada	maðruˈɣaða
amanecer	amaneˈθer
maɲana	
mediodía	
tarde	ˈtarðe
vísperas	
noche	ˈnoʧe
hoy	oi̯
maɲana	
pasado maɲana	
ayer	aˈɟer
anteayer	an̩teaˈɟer
hora	ˈora
reloj	rreˈlox
semana	seˈmana
domingo	doˈmiŋgo
lunes	ˈlunes
martes	ˈmartes
miércoles	
jueves	ˈxweβes
viernes	ˈbjernes
sábado	
mes	mes
aɲo	
invierno	imˈbjerno
primavera	primaˈβera
verano	beˈrano
otoɲo	
estación	
oler	oˈler
olfatear	olfateˈar
husmear	usmeˈar
oler	oˈler
olfatear	olfateˈar
fragante	fraˈɣan̩te
bien oliente	
hediondo	eˈðjon̩do
gustar	gusˈtar
saborear	saβoreˈar
dulce	ˈduḷθe
salado	saˈlaðo, -a
amargo	aˈmarɣo
ácido	
agrio	ˈaɣrjo, -a
salobre	saˈloβre
oír	
escuchar	eskuˈʧar
sonido	soˈniðo
ruido	ˈrrwiðo
alta	ˈal̩ta
ruidoso	rrwiˈðoso, -a
silencio	siˈleṇθjo
tranquilo	traŋˈkilo, -a
ver	ber
mirar	miˈrar
contemplar	kon̩temˈplar
mostrar	mosˈtrar
seɲalar	
brillar	briˈʎar
brillante	briˈʎan̩te
resplandor	rresplan̩ˈdor
color	koˈlor
claro	ˈklaro
oscuro	o<span class="super">β</span>sˈkuro, -a
blanco	ˈblaŋko
negro	ˈneɣro
rojo	ˈrroxo
azul	aˈθul
amarillo	amaˈriʎo
tocar	toˈkar
pellizcar	peʎiθˈkar
sentir	sen̩ˈtir
duro	ˈduro
suave	suˈaβe
áspero	
suave	suˈaβe
liso	ˈliso, -a
afilado	afiˈlaðo, -a
aguzado	aɣuˈθaðo, -a
filoso	fiˈloso, -a
romo	ˈrromo, -a
embotado	emboˈtaðo, -a
pesado	peˈsaðo, -a
liviano	liˈβjano, -a
ligero	liˈxero, -a
mojado	moˈxaðo
húmedo	
seco	ˈseko, -a
caliente	kaˈljen̩te
tibio	ˈtiβjo, -a
cálido	
frío	
limpio	ˈlimpjo
sucio	ˈsuθjo, -a
arrugado	arruˈɣaðo, -a
alma	ˈalma
sorprendido	
estupefacto	estupeˈfakto, -a
buena suerte	
mala suerte	
alegre	aˈleɣre
contento	kon̩ˈten̩to
feliz	feˈliθ
reír	
sonreír	
jugar	xuˈɣar
querer	keˈrer
amar	aˈmar
besar	beˈsar
abrazar	aβraˈθar
dolor	doˈlor
tristeza	trisˈteθa
dolor	doˈlor
pena	ˈpena
ansiedad	
angustia	aŋˈgustja
preocupación	
lamentar	lamen̩ˈtar
sentir	sen̩ˈtir
compasión	
lástima	
llorar	ʎoˈrar
lágrima	
gemir	xeˈmir
odiar	oˈðjar
enojo	eˈnoxo
ira	ˈira
rabia	ˈrraβja
envidia	emˈbidja
celos	
vergüenza	
orgulloso	orɣuˈʎoso, -a
osar	oˈsar
atreverse	atreˈβerse
valiente	baˈljen̩te
